111111111111111111111111
100000000011000100000001
101100000111000000111101
100100P00000000100000001
101100000111000000010101
100000000011000001110111
111101111111111111000001
111101111010101011010101
110000001101010111000001
100000000000000011000001
100011000000000011010101
110000001101010111110111
111101111111011111110111
111101111111001011000001
110000011100000011001001
100010001100000011000001
100000001111111011100011
100010001111111110010101
110000011100011010100011
100010001000001101010101
100000000001000000000001
100010001000001101010101
110000011100011010100011
111111111111111111111111