111111111111
100000000001
10000P000001
100000000001
100101001001
100101101001
100100101001
1O0010101001
1O0010101001
100011101001
100000000001
111111111111